R	1000	500
NO	./texture/eagle.xpm
SO	./texture/wolftextures.xpm
WE	./texture/wolftextures.xpm
EA	./texture/wolftextures.xpm

S	./texture/path_to_the_sprite_texture
F	220,100,0
C	225,30,0





11111111
1000000111111
10000000000001
100N000111111
10000001
10000001               1
10000001              101
10000001              101
1000000111111111111111101
10000000000000000000000001
1111111111111111111111111


