R 800 500
NO ./texture/eagle.xpm
SO ./texture/greystone.xpm
WE ./texture/purplestone.xpm
EA ./texture/redbrick.xpm

S ./texture/barrel.xpm
F 220,100,0
C 225,30,0

        111111111111111111111111111111111111111111111111111111111111111
        100000000011000000000000100000000000010000000100000000000000001
        101100000111000000200000100000000000001000001000000000000000001
        100100000000000000000000100000000000000100010000000000000000001
11111111101100000111000000000000100000000000000210100000000000000000001
10000000001100000111011111111111100000000000000001000000000000000000001
11110111111111011100000010001000000000000000000000000000000000000000001
11110111111111011101010010001000000000000000000000000000000000000000001
11000000110101011100000000001000220000000000000000000000000000000000001
1000200000000000110000001000100002000000000000000000N000000000000000001
10000000000000001101010010001000000000000000000000000000000000000000001
11000001110101011111011110001000000000000000000000000000000000000000001
11110111 1110101 101111010000000000000000000000000000000000000000000001
11111111 1111111 111111111111111111111111111111111111111111111111111111
