R 800 500
NO ./texture/darker_wall.xpm
SO ./texture/door_wall.xpm
WE ./texture/normal_wall.xpm
EA ./texture/normal_wall.xpm

S ./texture/player_green.xpm
T ./texture/player_blue.xpm
U ./texture/player_red.xpm
V ./texture/player_black.xpm
W ./texture/player_orange.xpm
a ./texture/player_white.xpm
b ./texture/player_brown.xpm
c ./texture/player_light_blue.xpm
d ./texture/player_lime.xpm
e ./texture/player_pink.xpm
f ./texture/player_purple.xpm
g ./texture/player_yellow.xpm
h ./texture/player_yellow_dead.xpm
F 92,92,92
C 94,91,140

111111111111111111111111111111111111111111111111111111111
111111111111111111111111111110000000011111111111111111111
111111111111111111111111111100000000001111111111111111111
111111111111111111111111111000000000000111100111111111111
111111111111111111111111112222222222222211100011111111111
111111111100011111111111110000000000000001100001111111111
111111111000011111111111110000000000000001100000111111111
111111110000040000000000040000000000000004000000111111111
111111110000011111114111110000000000000001100000111111111
111111110000011111000001110000000000000001110000111111111
111111110000011111000001110000000000000001111101111111111
111100111141111111000001110000000N00000011000141111111111
111000111101111111000000111000000000000110000101111111111
110000111101111111000000011100000000001100000400001100011
100000001101100011000000011110000000011100000111101100001
100000001101000003300000001111111411111111111111100400001
100000001101000001110000001111111004000000011111101100001
100000004004000001111113111111111011000000011110001100011
100000001101000001111113111111111411000000011110111111111
100000001101000001110j00011111100001000000011110111111111
100000001101000003330000011111000001000000111114111111111
110000111101111111110000011110000001000001111100001111111
111000111101111111110000011100000001111111111000001111111
111100111141111111111110011100000001111111110000001111111
111111110000011111110000011100000004000000040000001111111
111111110000011111110000011100000001111141110000001111111
111111110000040001110000111100000001000000010000011111111
111111110000011101110001111100000001000000010000111111111
111111111000011101114111111100000001000000010001111111111
111111111100011100000000000400000001000000011111111111111
111111111111111111111111111110000001100000111111111111111
111111111111111111111111111111000001111111111111111111111
111111111111111111111111111111100001111111111111111111111
111111111111111111111111111111111111111111111111111111111
