R 800 500
NO ./texture/darker_wall.xpm
SO ./texture/door_wall.xpm
WE ./texture/normal_wall.xpm
EA ./texture/normal_wall.xpm

S ./texture/player_green.xpm
T ./texture/player_blue.xpm
U ./texture/player_red.xpm
V ./texture/player_yellow.xpm
W ./texture/player_orange.xpm
F 92,92,92
C 94,91,140

1111111111111111111111111111111111111111111
1111111111111111111111000001111111111111111
1111111111111111111110000000111111111111111
1111111111111111111120000020011100111111111
1111111100011111111000000000001102011111111
1111111000011111111000000000001100001111111
1111110200000000000000000000000000001111111
111111000001111101100000N000001100001111111
1111110000011100001000200000001110001111111
1112010000011100001100000000010011011111111
1100011101100100000110000000100000000110211
1000000101002012222111000001120011110110001
1000000101000012222111110111111111110000001
1000000000000011111111110110002011110110001
1000000101000010200111110000000011000112011
1000000101000010000111110110000011011111111
1100011101111111100111000010000111011111111
1112010000011110000110000011111110001111111
1111110000011110000120000011111120001111111
1111110000000110001100000000000000001111111
1111110000010110111100000011101100001111111
1111111000010000000000000012000100011111111
1111111111111111111110002010000111111111111
1111111111111111111111000011001111111111111
1111111111111111111111111111111111111111111
