R 800 500
NO ./texture/darker_wall.xpm
SO ./texture/door_wall.xpm
WE ./texture/normal_wall.xpm
EA ./texture/normal_wall.xpm
. ./texture/heal_cross.xpm
, ./texture/heal_wall.xpm
_ ./texture/heal_control.xpm
@ ./texture/wall_control.xpm

S ./texture/player_green.xpm
T ./texture/player_blue.xpm
U ./texture/player_red.xpm
V ./texture/player_black.xpm
W ./texture/player_orange.xpm
a ./texture/player_white.xpm
b ./texture/player_brown.xpm
c ./texture/player_light_blue.xpm
d ./texture/player_lime.xpm
e ./texture/player_pink.xpm
f ./texture/player_purple.xpm
g ./texture/player_yellow.xpm
h ./texture/player_yellow_dead.xpm
k ./texture/bad_brown.xpm
l ./texture/bad_green.xpm
m ./texture/bad_pink.xpm
n ./texture/heart.xpm
o ./texture/scan.xpm
F 92,92,92
C 94,91,140

111111111111111111111111111111111111111111111111111111111
111111111111111111111111111110000000011111111111111111111
1111111111111111111111111111000200000011111@1111111111111
111111111111111111111111111000000000000111100111111111111
111111111111111111111111110000000000200011100011111111111
111111111100011111111111110200000000000001100001111111111
111111111000011111111111110000000000000001100000111111111
111111110000040000000000040000000000000004000020111111111
111111110000011111,.4.,1110000000000000001100000111111111
11111111000001111,00000,110000000000000001110000111111111
1111@111000001111,00000,110000000000000001111101111111111
11110011114111111,00000.112000000N00000011000141111111111
11100011110111111.000000,11000000000000110000101111111111
11000011110111@11,0000000,1100000000003300000400001100011
10000000110110001,0000000_111000000001110000011110110000@
120000001101002001,0000o00,1111114111111@@11111110040020@
1000000011010000011,000000,11111100400000001111110110000@
10000000400400000111,,,,,,1111111011000000011110001100011
100000001101000001111111111111111411000000011110111111111
100000001101000001110000011111100001000002011110111111111
100000001101000003330000011111000001000000111114111111111
110000111101111111110000011110000001000001111100001111111
111000111101111111110000011100000001111111111000001111111
111100111141111111111110011100000001111111110000001111111
1111@1110000011111112000011100000004000000040000001111111
111111110000011111110000011100000001111141110000001111111
11111111000004000111000011110000000100l000010000011111111
111111110000011101110001111100000001000000010000111111111
1111111110000111011141111111000000010k0000m12001111111111
111111111100011100000000000400000001000000011111111111111
111111111111111111111111111110000001100000111111111111111
11111111111111111111111111111100000111@@11111111111111111
111111111111111111111111111111100021111111111111111111111
111111111111111111111111111111111111111111111111111111111
