R 800 500
NO ./texture/darker_wall.xpm
SO ./texture/door_wall.xpm
WE ./texture/normal_wall.xpm
EA ./texture/normal_wall.xpm
. ./texture/heal_cross.xpm
, ./texture/heal_wall.xpm
_ ./texture/heal_control.xpm
@ ./texture/wall_control.xpm
# ./texture/technic.xpm
$ ./texture/window.xpm

S ./texture/player_green.xpm
T ./texture/player_blue.xpm
U ./texture/player_red.xpm
V ./texture/player_black.xpm
W ./texture/player_orange.xpm
a ./texture/player_white.xpm
b ./texture/player_brown.xpm
c ./texture/player_light_blue.xpm
d ./texture/player_lime.xpm
e ./texture/player_pink.xpm
f ./texture/player_purple.xpm
g ./texture/player_yellow.xpm
h ./texture/player_yellow_dead.xpm
k ./texture/bad_brown.xpm
l ./texture/bad_green.xpm
m ./texture/bad_pink.xpm
n ./texture/heart.xpm
o ./texture/scan.xpm
F 92,92,92
C 94,91,140

1111111111111111111
1000100010001000121
1000001000100010111
10001111111111101
101E0000400000001
1j111111111111111
121
111
