R	1000	500
NO	./texture/eagle.xpm
SO	./texture/wolftextures.xpm
WE	./texture/wolftextures.xpm
EA	./texture/wolftextures.xpm

S	./texture/path_to_the_sprite_texture
F	220,100,0
C	225,30,0

11111111
1000N000
11111111
